 - Dock zone has no control	 - ¸ÃÇøÓòÎÞ¿É¹©Í£¿¿µÄ´°Ìå	Consts_SDockZoneHasNoCtl
 - Dock zone not found	 - ÎÞ·¨Í£¿¿	Consts_SDockZoneNotFound
%d files selected	ÒÑÑ¡Ôñ %d ¸öÎÄ¼þ	DialogsEx_rsDFilesSelected
%d is an invalid PageIndex value.  PageIndex must be between 0 and %d	%d ²»ÊÇÓÐÐ§µÄÒ³ÂëÖµ¡£Ò³ÂëÖµ±ØÐëÔÚ 0 - %d Ö®¼ä¡£	ComStrs_sPageIndexError
%d link points defined	ÒÑ¶¨Òå %d ¸ö¶¥µã	PropertyEditor_rsDLinkPointsDefined
%s (%s, line %d)	%s (%s, line %d)	SysConst_SAssertError
%s does not allow hiding	²»ÔÊÐíÒþ²Ø %s	Consts_SCannotHideActionBand
%s expected	%s expected	ExpressionEval_rsSExpected
%s not found	%s not found	ExpressionEval_rsSNotFound
%s not in a class registration group	%s not in a class registration group	RTLConsts_SUnknownGroup
%s on %s	%s on %s	Consts_SDeviceOnPort
%s property out of range	%s property out of range	Consts_SPropertyOutOfRange
%s.Seek not implemented	%s.Seek not implemented	RTLConsts_SSeekNotImplemented
&Abort	ÖÐ¶Ï(&A)	Consts_SMsgDlgAbort
&Add or Remove Buttons	Ìí¼Ó/ÒÆ³ý°´Å¥(&A)	Consts_SAddRemoveButtons
&All	È«²¿(&A)	Consts_SMsgDlgAll	Consts_SAllButton
&Close	¹Ø±Õ(&C)	Consts_SCloseButton
&Help	°ïÖú(&H)	Consts_SMsgDlgHelp	Consts_SHelpButton
&Ignore	ºöÂÔ(&I)	Consts_SMsgDlgIgnore	Consts_SIgnoreButton
&No	·ñ(&N)	Consts_SMsgDlgNo	Consts_SNoButton
&Retry	ÖØÊÔ(&R)	Consts_SMsgDlgRetry	Consts_SRetryButton
&Start	¿ªÊ¼(&S)	SpellChecker_rsStart
&Yes	ÊÇ(&Y)	Consts_SMsgDlgYes	Consts_SYesButton
'%s' is not a valid integer value	ÎÞÐ§µÄÕûÊýÖµ '%s'	SysConst_SInvalidInteger
''%s'' is not a valid component name	ÎÞÐ§µÄ×é¼þÃû³Æ ''%s''	RTLConsts_SInvalidName
(No Name)	(Î´ÃüÃû)	Consts_SNoName
25%#$0D50%#$0D75%#$0D100%#$0D150%#$0D200%#$0D400%#$0D800%#$0D	25%#$0D50%#$0D75%#$0D100%#$0D150%#$0D200%#$0D400%#$0D800%#$0D	TMainForm: ZoomBox.Items.Strings
3D Dark Shadow	3D Dark Shadow	ExtCtrls_clName3DDkShadow
3D Light	3D Light	ExtCtrls_clName3DLight
<unknown>	<Î´Öª>	SysConst_SUnknown
= or ( expected	Î´ÕÒµ½Ô¤ÆÚµÄ = »ò (	ExpressionEval_rsOrExpected
A call to an OS function failed	ºô½ÐÏµÍ³·þÎñÊ§°Ü	SysConst_SUnkOSError
A class named %s already exists	ÀàÃû %s ÖØ¸´	RTLConsts_SDuplicateClass
A component named %s already exists	×é¼þÃû %s ÖØ¸´	RTLConsts_SDuplicateName
A control cannot have itself as its parent	×é¼þ²»ÄÜÒÔ×ÔÉíÎª¸¸×é¼þ	Consts_SControlParentSetToSelf
Abort	ÖÐ¶Ï(&A)	Consts_SAbortButton
About	¹ØÓÚ	TAboutBox: AboutBox.Caption
About...	¹ØÓÚ(&A)...	TMainForm: ActionManager.Caption	TMainForm: ActionManager.Caption	TMainForm: ActionManager.Caption	TMainForm: AboutAction.Caption
Abstract Error	Abstract Error	SysConst_SAbstractError
Active Border	Active Border	ExtCtrls_clNameActiveBorder
Active Caption	Active Caption	ExtCtrls_clNameActiveCaption
Add	Ìí¼Ó(&A)	TLinkEditorForm: AddButton.Caption	TSpellCheckForm: AddButton.Caption
Add template	Ìí¼ÓÄ£°å(&A)	TMainForm: ActionManager.Caption	TMainForm: AddTemplateAction.Caption
Add to template palette	Ìí¼Óµ½Ä£°åÃæ°å(&A)	TMainForm: AddTemplateAction.Hint
Adjust page dimensions and orientation		TMainForm: PagePropertiesAction.Hint
Adler32 error	Adler32 error	Adler32_rsAdler32Error
Align	¶ÔÆë(&L)	TMainForm: ActionManager.Caption	TMainForm: AlignMenuAction.Caption	TMainForm: AlignMenu.Caption
Align single object to page or multiple objects to group	¶ÔÆëµ¥¸ö¶ÔÏóµ½µ±Ç°Ò³»ò¶à¸ö¶ÔÏóµ½×éºÏ	TMainForm: AlignCenterHAction.Hint
All objects in group must be simple lines	×éºÏÖÐËùÓÐ¶ÔÏóÐëÎª¼òµ¥µÄÏßÌõ	GroupObject_rsAllObjectsInGroupMustBeSimpleLines
Alt+	Alt+	Consts_SmkcAlt
An error occurred while reading the FixedFileInfo structure from the file.	´ÓÎÄ¼þ¶ÁÈ¡ FixedFileInfo ½á¹¹Ê±·¢Éú´íÎó¡£	VersionInfo_rs_readfixedfileinfo
An error occurred while reading the language/charset description in the file.	´ÓÎÄ¼þ¶ÁÈ¡ÓïÑÔ/×Ö·û¼¯ÃèÊöÊ±·¢Éú´íÎó¡£	VersionInfo_rs_readlanginfo
Ancestor for '%s' not found	Ancestor for '%s' not found	RTLConsts_SAncestorNotFound
Anchors		TPropertyEditorForm: PanelAnchors.Caption
Anchors used when resizing group		TPropertyEditorForm: PanelAnchors.Hint
Antialiasing		TDesignerSetupForm: AntialiasingBox.Caption
Antialiasing for slide show and bitmap export		TDesignerSetupForm: AntialiasingBox.Hint
Any angle...	ÈÎÒâ½Ç¶È(&A)...	TMainForm: ActionManager.Caption	TMainForm: RotateAction.Caption
Application Error	Application Error	SysConst_SExceptTitle
Application Workspace	Application Workspace	ExtCtrls_clNameAppWorkSpace
Apply to all pages	Ó¦ÓÃµ½ËùÓÐÒ³Ãæ	TPagePropertiesForm: ApplyToAllBox.Caption
Apr	Apr	SysConst_SShortMonthNameApr
April	April	SysConst_SLongMonthNameApr
Aqua	Aqua	ExtCtrls_clNameAqua
Arrow 1	Arrow 1	LineObject_rsArrow1
Arrow 2	Arrow 2	LineObject_rsArrow2
Arrow 3	Arrow 3	LineObject_rsArrow3
Assertion failed	Assertion failed	SysConst_SAssertionFailed
Associate file formats with	½«ÎÄ¼þ¸ñÊ½¹ØÁªµ½	TFormatAssociateForm: FormatAssociateForm.Caption
Associate program with selected file formats	¹ØÁªÑ¡¶¨µÄÎÄ¼þ¸ñÊ½µ½³ÌÐò	TFormatAssociateForm: AssociateButton.Hint
Aug	Aug	SysConst_SShortMonthNameAug
August	August	SysConst_SLongMonthNameAug
Auto line break		TMainForm: AutoLineBreakAction.Caption
Automatically break lines in text boxes		TMainForm: AutoLineBreakAction.Hint
Automatically create link points when grouping objects		TDesignerSetupForm: DefaultGroupLinksBox.Hint
Automatically set anchors when grouping objects so that the group can be scaled		TDesignerSetupForm: DefaultGroupAnchorsBox.Hint
Background	Background	ExtCtrls_clNameBackground
Ball	Ball	LineObject_rsBall
Base 10 logarithm	Base 10 logarithm	ExpressionEval_rsBase10Logarithm
Base 2 logarithm	Base 2 logarithm	ExpressionEval_rsBase2Logarithm
Base e logarithm	Base e logarithm	ExpressionEval_rsBaseELogarithm
Bilinear interpolation stretch (not supported with transparency)		TPropertyEditorForm: HalftoneCheckBox.Hint
Bitmap	Î»Í¼	Main_rsBitmap	TPropertyEditorForm: Panel15.Caption
Bitmap image is not valid	ÎÞÐ§µÄÎ»Í¼	Consts_SInvalidBitmap
Bitmap scaling	Ëõ·Å±ÈÀý	TPropertyEditorForm: Panel16.Caption
Bitmaps	¶à¸öÎ»Í¼	Consts_SVBitmaps
Bits index out of range	Bits index out of range	RTLConsts_SBitsIndexError
BkSp	BkSp	Consts_SmkcBkSp
Black	ºÚÉ«	ExtCtrls_clNameBlack
Blue	À¶É«	ExtCtrls_clNameBlue
Bold	´ÖÌå	TextEditor_rsBold
Bottom	µ×²¿¶ÔÆë(&B)	TMainForm: ActionManager.Caption	TMainForm: AlignBottomAction.Caption	TPropertyEditorForm: BottomAnchorBox.Hint
Bring to front	ÌáÉýÏÔÊ¾ÓÅÏÈ¼¶(&B)	TMainForm: ActionManager.Caption	TMainForm: BringToFrontAction.Caption
Button Face	Button Face	ExtCtrls_clNameBtnFace
Button Highlight	Button Highlight	ExtCtrls_clNameBtnHighlight
Button Shadow	Button Shadow	ExtCtrls_clNameBtnShadow
Button Text	Button Text	ExtCtrls_clNameBtnText
CRC error	CRC error	PNGLoader_rsCRCError
Can't write to a read-only resource stream	Can't write to a read-only resource stream	RTLConsts_SCantWriteResourceStreamError
Cancel	È¡Ïû(&C)	TFormatAssociateForm: CancelButton.Caption	TLanguageSelectorForm: CancelButton.Caption	TIconSelectionForm: CancelButton.Caption	TDesignerSetupForm: Button1.Caption	PropertyEditor_rsCancel	Consts_SMsgDlgCancel	Consts_SCancelButton	TLinkEditorForm: Button1.Caption	TPagePropertiesForm: CancelBtn.Caption	TPasteSpecialForm: CancelBtn.Caption	TPropertyEditorForm: CancelButton.Caption	TTextEditorForm: CancelButton.Caption
Cannot assign a %s to a %s	Cannot assign a %s to a %s	RTLConsts_SAssignError
Cannot assign a subitem to an actionbar when one of it's parent's is already assigned to an actionbar	Cannot assign a subitem to an actionbar when one of it's parent's is already assigned to an actionbar	Consts_SAssignSubItemError
Cannot change Visible in OnShow or OnHide	Cannot change Visible in OnShow or OnHide	Consts_SVisibleChanged
Cannot change the size of a JPEG image	Cannot change the size of a JPEG image	JConsts_sChangeJPGSize
Cannot change the size of an icon	Cannot change the size of an icon	Consts_SChangeIconSize
Cannot create file \"%s\". %s	Cannot create file \"%s\". %s	RTLConsts_SFCreateErrorEx
Cannot create form. No MDI forms are currently active	Cannot create form. No MDI forms are currently active	Consts_SNoMDIForm
Cannot drag a form	Cannot drag a form	Consts_SCannotDragForm
Cannot focus a disabled or invisible window	Cannot focus a disabled or invisible window	Consts_SCannotFocus
Cannot hide an MDI Child Form	Cannot hide an MDI Child Form	Consts_SMDIChildNotVisible
Cannot make a visible window modal	Cannot make a visible window modal	Consts_SCannotShowModal
Cannot open clipboard	Cannot open clipboard	Consts_SCannotOpenClipboard
Cannot open file \"%s\". %s	Cannot open file \"%s\". %s	RTLConsts_SFOpenErrorEx
Canvas does not allow drawing	Canvas does not allow drawing	Consts_SNoCanvasHandle
Caption Text	Caption Text	ExtCtrls_clNameCaptionText
Center	¾ÓÖÐ(&C)	TMainForm: ActionManager.Caption	TMainForm: ActionManager.Caption	TMainForm: AlignCenterVAction.Caption	TMainForm: AlignCenterHAction.Caption
Change color of all objects in active layer	¸Ä±äµ±Ç°²ãÖÐËùÓÐ¶ÔÏóµÄÑÕÉ«	TMainForm: SetLayerColorAction.Hint
Change value	Change value	ExpressionHelp_rsChangeValue
Check active layer only	Ö»¼ì²éµ±Ç°²ã	TSpellCheckForm: ActiveLayerOnlyBox.Caption
Check for updates		TMainForm: ActionManager.Caption	TMainForm: CheckForUpdatesAction.Caption
CheckSynchronize called from thread $%x, which is NOT the main thread	CheckSynchronize called from thread $%x, which is NOT the main thread	RTLConsts_SCheckSynchronizeError
Circle	Ô²ÐÎ	LineObject_rsCircle
Circular decoder table entry	Circular decoder table entry	GIFImage_sDecodeCircular
Circular references not allowed	Circular references not allowed	Consts_SCirularReferencesNotAllowed
Class %s not found	Class %s not found	RTLConsts_SClassNotFound
Clear	Çå³ý	TPropertyEditorForm: ClearLinksButton.Caption	TPropertyEditorForm: Button1.Caption	TPropertyEditorForm: Button2.Caption	TPropertyEditorForm: ClearColorKeyButton.Caption	TPropertyEditorForm: Button3.Caption
Click here to see how	²é¿´ÏêÇé	TPleaseSupportForm: Label4.Caption
Click to apply format to selection		TTextEditorForm: LabelCode1.Hint	TTextEditorForm: LabelCode2.Hint
Clipboard does not support Icons	Clipboard does not support Icons	Consts_SIconToClipboard
Clipboard metafile scale:	Í¼ÔªÊý¾Ý¿½±´Ëõ·Å±ÈÀý:	TDesignerSetupForm: Label4.Caption
Close	¹Ø±Õ(&C)	TExpressionEvalForm: ActionClose.Caption	TExpressionPlotForm: Button1.Caption	TMainForm: ActionManager.Caption	TMainForm: ActionManager.Caption	TMainForm: ExitAction.Caption	TSlideShowForm: CloseItem.Caption	TSpellCheckForm: CloseButton.Caption
Close Expression evaluator	Close Expression evaluator	TExpressionEvalForm: ActionClose.Hint
Color not in color table	Color not in color table	GIFImage_sInvalidColor
Color table is empty	Color table is empty	GIFImage_sEmptyColorMap
Color table overflow	Color table overflow	GIFImage_sTooManyColors
Conditional value		ExpressionEval_rsConditionalValue
Confirm	È·ÈÏ	Consts_SMsgDlgConfirm
Connect links	Áª½á(&C)	TMainForm: ActionManager.Caption	TMainForm: ConnectLinksAction.Caption
Continue	¼ÌÐø(&C)	TPleaseSupportForm: CloseButton.Caption
Control '%s' has no parent window	Control '%s' has no parent window	Consts_SParentRequired
Control-C hit	Control-C hit	SysConst_SControlC
Convert	×ª»»(&C)	TMainForm: Convert1.Caption
Convert binary number	Convert binary number	ExpressionEval_rsConvertBinaryNumber
Convert group object consisting of connected lines to polygon	×ª»»°üº¬Á¬½ÓÏßµÄ×éºÏ¶ÔÏóÎª¶à±ßÐÎ	TMainForm: MakePolygonAction.Hint
Convert to metafile	×ª»»ÎªÍ¼Ôª(&M)	TMainForm: ActionManager.Caption	TMainForm: MakeMetafileAction.Caption
Convert to polygon	×ª»»Îª¶à±ßÐÎ(&P)	TMainForm: ActionManager.Caption	TMainForm: MakePolygonAction.Caption
Converting...	Converting...	GIFImage_sProgressConverting
Copy	¸´ÖÆ(&C)	TExpressionPlotForm: CopyButton.Caption	TMainForm: ActionManager.Caption	TMainForm: ActionManager.Caption	TMainForm: ActionManager.Caption	TMainForm: ActionManager.Caption	TMainForm: CopyAction.Caption
Copy templates to page	¸´ÖÆÄ£°åµ½µ±Ç°Ò³(&C)	TMainForm: ActionManager.Caption	TMainForm: TemplateToPageAction.Caption
Copying...	Copying...	GIFImage_sProgressCopying
Corner radius		Main_rsCornerRadius	TMainForm: CornerRadiusAction.Hint	TPropertyEditorForm: Panel22.Caption
Could not convert variant of type (%s) into type (%s)	Could not convert variant of type (%s) into type (%s)	SysConst_SVarTypeCouldNotConvert
Cream	Cream	ExtCtrls_clNameCream
Create default anchors for groups		TDesignerSetupForm: DefaultGroupAnchorsBox.Caption
Create default link points for groups		TDesignerSetupForm: DefaultGroupLinksBox.Caption
Crop to page contents		DiagramExport_rsAutoCrop
Ctrl+	Ctrl+	Consts_SmkcCtrl
Curve must be closed Catmull-Rom spline or line segments		LineObject_rsCurveMustBeClosedCatmullRomSpline
Curve type		TPropertyEditorForm: Panel23.Caption
Cut	¼ôÇÐ(&T)	TMainForm: ActionManager.Caption	TMainForm: ActionManager.Caption	TMainForm: ActionManager.Caption	TMainForm: ActionManager.Caption	TMainForm: CutAction.Caption
Dec	Dec	SysConst_SShortMonthNameDec
December	December	SysConst_SLongMonthNameDec
Decoder bit buffer under-run	Decoder bit buffer under-run	GIFImage_sDecodeTooFewBits
Default	Default	ExtCtrls_clNameDefault	TMainForm: DefaultPaletteItem.Caption
Default font...	Ä¬ÈÏ×ÖÌå(&D)...	TMainForm: ActionManager.Caption	TMainForm: DiagramFontAction.Caption
Del	Del	Consts_SmkcDel
Delete	É¾³ý(&D)	TLinkEditorForm: DeleteButton.Caption	TMainForm: ActionManager.Caption	TMainForm: ActionManager.Caption	TMainForm: ActionManager.Caption	TMainForm: DeleteAction.Caption	TRearrangePagesForm: DeleteButton.Caption
Delete diagram page?	É¾³ýÑ¡¶¨Ò³Ãæ£¿	RearrangePages_rsDeleteDiagramPage
Delete symbol	É¾³ý·ûºÅ	TExpressionEvalForm: DeleteSymbolItem.Caption
Delete template object	É¾³ýÄ£°å¶ÔÏó	TMainForm: DeleteTemplateAction.Caption
Description	ÃèÊö	TFormatAssociateForm: DescriptionBox.Caption	TExpressionEvalForm: ListView.Caption
Deselect all	È¥Ñ¡(&D)	TFormatAssociateForm: NoneButton.Caption
Diagram	Í¼±í(&D)	TMainForm: ActionManager.Caption	TMainForm: DiagramMenuAction.Caption
Diagram (*.ddd)|*.ddd	Í¼±íÎÄ¼þ (*.ddd)|*.ddd	DiagramBase_rsDiagramFileFilter
Diagram modified, save before closing?	ÊÇ·ñ±£´æµ±Ç°Í¼±íµÄ±ä¸ü£¿	Main_rsDiagramModifiedSaveBeforeClosing
Diagram or Internet link	Í¼±í/Internet ¿ì½Ý·½Ê½	TextEditor_rsDiagramOrInternetLink
Diagram template palette (*.ddt)|*.ddt	Í¼±íÄ£°åÎÄ¼þ (*.ddt)|*.ddt	DiagramBase_rsTemplatePaletteFilter
Diamond		LineObject_rsDiamond
Dictionaries (*.dic)|*.dic	´ÊµäÎÄ¼þ (*.dic)|*.dic	DesignerSetup_rsDictionariesDicDic
Disable font antialiasing		DiagramExport_rsDisableFontAntialiasing
Disk full	´ÅÅÌ¿Õ¼äÒÑÂú	SysConst_SDiskFull
Distance from top left corner	×óÉÏ½Ç¼ä¾à	TPropertyEditorForm: Panel10.Hint	TPropertyEditorForm: Panel11.Hint
Distribute		TMainForm: ActionManager.Caption	TMainForm: ActionManager.Caption	TMainForm: AlignDistributeVAction.Caption	TMainForm: AlignDistributeHAction.Caption
Division by zero	Division by zero	SysConst_SDivByZero
Docked control must have a name	Docked control must have a name	Consts_SDockedCtlNeedsName
Done	Íê³É	PropertyEditor_rsDone
Double arrow	Ë«¼ýÍ·	LineObject_rsDoubleArrow3
Down	Down	Consts_SmkcDown
Download	ÏÂÔØ	PropertyEditor_rsDownload
Draw arrow	ÏòÏÂ¼ýÍ·	TMainForm: DrawArrowAction.Caption
Draw connector	»æÖÆÁ¬Ïß	TMainForm: DrawConnectorAction.Caption
Draw curve	»æÖÆÇúÏß	TMainForm: DrawCurveAction.Caption
Draw ellipse	»æÖÆÍÖÔ²	TMainForm: DrawEllipseAction.Caption
Draw line	»æÖÆÖ±Ïß	TMainForm: DrawLineAction.Caption
Draw rectangle	»æÖÆ¾ØÐÎ	TMainForm: DrawRectangleAction.Caption
Draw shadows below objects		TMainForm: ObjectShadowsAction.Hint
Edit	±à¼­(&E)	Main_rsEdit	TLinkEditorForm: EditButton.Caption	TMainForm: ActionManager.Caption	TMainForm: ActionManager.Caption	TMainForm: ActionManager.Caption	TMainForm: MouseEditAction.Caption	TMainForm: EditMenuAction.Caption	TPropertyEditorForm: EditBitmapButton.Caption	TPropertyEditorForm: EditLinksButton.Caption
Edit layer	±à¼­²ã(&E)	TMainForm: ActionManager.Caption	TMainForm: EditLayerMenuAction.Caption
Edit link point	±à¼­¶¥µã	LinkEditor_rsEditLinkPoint
Edit text	±à¼­ÎÄ×Ö	TTextEditorForm: TextEditorForm.Caption
Edit text...	±à¼­ÎÄ×Ö(&E)...	TMainForm: ActionManager.Caption	TMainForm: EditTextAction.Caption
Editing image...	±à¼­Í¼Ïó(&E)...	PropertyEditor_rsEditingImage
Either read, write or full access must be specified in call to CreateFile	Either read, write or full access must be specified in call to CreateFile	Streams_rs_NoFileAccessSpec
End	End	Consts_SmkcEnd
Enhanced Metafiles	Enhanced Metafiles	Consts_SVEnhMetafiles
Enter	Enter	Consts_SmkcEnter
Enter object text:	¼üÈë¶ÔÏóÎÄ±¾:	TTextEditorForm: Label2.Caption
Error	´íÎó	Consts_SMsgDlgError
Error closing \"%s\" - %s	¹Ø±Õ \"%s\" Ê±·¢Éú´íÎó - %s	Streams_rs_CloseFileError
Error creating variant or safe array	´´½¨ variant »ò safe array Ê±·¢Éú´íÎó	SysConst_SVarArrayCreate
Error creating window class	´´½¨´°ÌåÀàÊ±·¢Éú´íÎó	Consts_SWindowClass
Error creating window device context	´´½¨ DC Ê±·¢Éú´íÎó	Consts_SWindowDCError
Error deleting \"%s\" - %s	É¾³ý \"%s\" Ê±·¢Éú´íÎó - %s	Streams_rs_DeleteFileError
Error in bitmap data	²»¹æ·¶µÄÎ»Í¼¸ñÊ½	AnalyzerPlugins_rsErrorInBitmapData	LinarBitmap_rsErrorInBitmapData
Error in compressed data	²»¹æ·¶µÄÑ¹ËõÊý¾Ý	Deflate_rsErrorInCompressedData
Error loading previously saved settings file: %s\rWould you like to delete it?	¶ÁÈëÉèÖÃÎÄ¼þÊ±·¢Éú´íÎó: %s\rÊÇ·ñÉ¾³ý´ËÉèÖÃÎÄ¼þ£¿	Consts_SErrorLoadingFile
Error moving file pointer - %s	Error moving file pointer - %s	Streams_rs_SeekFileError
Error moving stream pointer	Error moving stream pointer	MemStream_rs_SeekMemError
Error opening \"%s\" - %s	Error opening \"%s\" - %s	Streams_rs_CreateFileError
Error reading %s%s%s: %s	Error reading %s%s%s: %s	RTLConsts_SPropertyException
Error reading from stream - %s	Error reading from stream - %s	Streams_rs_ReadError
Error removing control from dock tree	Error removing control from dock tree	Consts_SDockTreeRemoveError
Error running Image Analyzer	Error running Image Analyzer	PropertyEditor_rsErrorRunningImageAnalyzer
Error setting %s.Count	Error setting %s.Count	Consts_SErrorSettingCount
Error truncating file \"%s\" - %s	Error truncating file \"%s\" - %s	Streams_rs_TruncateFileError
Error while trying to send e-mail		EMailUtils_rsErrorWhileTryingToSendEMail
Error writing to stream - %s	Error writing to stream - %s	Streams_rs_WriteError
Esc	Esc	Consts_SmkcEsc
Evaluate	ÇóÖµ	TExpressionEvalForm: ActionRun.Caption	TExpressionEvalForm: ActionRun.Hint
Evaluate (F5)	ÇóÖµ (F5)	TExpressionEvalForm: RunButton.Caption
Exception %s in module %s at %p.\r\n%s%s\r\n	Exception %s in module %s at %p.\r\n%s%s\r\n	SysConst_SException
Exception in safecall method	Exception in safecall method	SysConst_SSafecallException
Expand	Õ¹¿ª	Consts_SExpand
Export	µ¼³ö	TPropertyEditorForm: ExportBitmapButton.Caption	TPropertyEditorForm: ExportMetafileButton.Caption
Export all pages		DiagramExport_rsExportAllPages
Export file DPI:	DPI ÉèÖÃ:	DiagramExport_rsExportFileDPI
Export page to bitmap or metafile	µ¼³öÎªÎ»Í¼»òÍ¼ÔªÎÄ¼þ	TMainForm: ExportAction.Hint
Export page...	µ¼³öµ±Ç°Ò³(&E)...	TMainForm: ActionManager.Caption	TMainForm: ExportAction.Caption
Expression evaluator	±í´ïÊ½ÇóÖµ	TExpressionEvalForm: ExpressionEvalForm.Caption
Expression evaluator...	±í´ïÊ½ÇóÖµ(&E)...	TMainForm: ActionManager.Caption	TMainForm: ExpressionEvaluator.Caption
Expression is empty	±í´ïÊ½Îª¿Õ	ExpressionEval_rsExpressionIsEmpty
External exception %x	External exception %x	SysConst_SExternalException
Extra = found	·¢ÏÖ¶àÓàµÄ "=" ·ûºÅ	ExpressionEval_rsExtraFound
Failed to Load Stream	Failed to Load Stream	ComStrs_sRichEditLoadFail
Failed to Save Stream	Failed to Save Stream	ComStrs_sRichEditSaveFail
Failed to allocate memory for GIF DIB	Failed to allocate memory for GIF DIB	GIFImage_sOutOfMemDIB
Failed to clear tab control	Failed to clear tab control	ComStrs_sTabFailClear
Failed to delete tab at index %d	Failed to delete tab at index %d	ComStrs_sTabFailDelete
Failed to get data for '%s'	Failed to get data for '%s'	RTLConsts_SRegGetDataFailed
Failed to get object at index %d	Failed to get object at index %d	ComStrs_sTabFailGetObject
Failed to read ImageList data from stream	Failed to read ImageList data from stream	Consts_SImageReadFail
Failed to retrieve tab at index %d	Failed to retrieve tab at index %d	ComStrs_sTabFailRetrieve
Failed to set data for '%s'	Failed to set data for '%s'	RTLConsts_SRegSetDataFailed
Failed to set object at index %d	Failed to set object at index %d	ComStrs_sTabFailSetObject
Failed to set tab \"%s\" at index %d	Failed to set tab \"%s\" at index %d	ComStrs_sTabFailSet
Failed to store GIF on clipboard	Failed to store GIF on clipboard	GIFImage_sFailedPaste
Failed to write ImageList data to stream	Failed to write ImageList data to stream	Consts_SImageWriteFail
Feb	Feb	SysConst_SShortMonthNameFeb
February	February	SysConst_SLongMonthNameFeb
File	ÎÄ¼þ(&F)	TMainForm: ActionManager.Caption	TMainForm: ActionManager.Caption	TMainForm: ActionManager.Caption	TMainForm: FileMenuAction.Caption
File access denied	File access denied	SysConst_SAccessDenied
File format associations	¹ØÁªÎÄ¼þ¸ñÊ½	TDesignerSetupForm: FileFormatAssociationsButton.Caption
File from later program version	¸ÃÎÄ¼þÊÇÓÉ½Ï¸ß°æ±¾µÄ³ÌÐò´´½¨µÄ¡£Òª¶ÁÈ¡´ËÎÄ¼þ£¬Çë¸üÐÂ±¾³ÌÐò¡£	DiagramBase_rsFileFromLaterProgramVersion
File not found	File not found	SysConst_SFileNotFound
Fill	Ìî³ä(&F)	TMainForm: ActionManager.Caption	TMainForm: AlignPageAction.Caption
Fill color	Ìî³äÑÕÉ«	TMainForm: FillColorAction.Hint	TPropertyEditorForm: Panel6.Caption
Find text...		TMainForm: ActionManager.Caption	TMainForm: FindTextAction.Caption
Find x that minimizes expression	Find x that minimizes expression	ExpressionEval_rsFindXThatMinimizesExpression
First	Ê×Ò³(&F)	TSlideShowForm: FirstSlideItem.Caption
Flip	µßµ¹(&F)	TMainForm: ActionManager.Caption	TMainForm: FlipUDAction.Caption	TPagePropertiesForm: FlipButton.Caption
Floating point division by zero	Floating point division by zero	SysConst_SZeroDivide
Floating point overflow	Floating point overflow	SysConst_SOverflow
Floating point underflow	Floating point underflow	SysConst_SUnderflow
Font	×ÖÌå	TextEditor_rsFont
Format '%s' invalid or incompatible with argument	Format '%s' invalid or incompatible with argument	SysConst_SInvalidFormat
Format string too long	Format string too long	SysConst_SFormatTooLong
Fractional part of real number	Fractional part of real number	ExpressionEval_rsFractionalPartOfRealNumber
Fri	Fri	SysConst_SShortDayNameFri
Friday	Friday	SysConst_SLongDayNameFri
Fuchsia	Fuchsia	ExtCtrls_clNameFuchsia
GIF Image	GIF Image	GIFImage_sGIFImageFile
Gaussian random number, StdDev=x	Gaussian random number, StdDev=x	ExpressionEval_rsGaussianRandomNumberStdDevX
General	³£¹æ	TPropertyEditorForm: TabSheet1.Caption
Get printer page format	»ñÈ¡´òÓ¡»úÒ³ÃæÉèÖÃ	TPagePropertiesForm: PrinterButton.Caption
Global stencil	±³¾°²ã(&G)	TMainForm: ActionManager.Caption	TMainForm: EditStencilAction.Caption
Glue connectors to adjoining object link points in active layer	Áª½áµ±Ç°²ãÖÐÏàÁÚ¶ÔÏóµÄ¶¥µã	TMainForm: ConnectLinksAction.Hint
Go to page	×ªµ½Ò³Âë	TSlideShowForm: GoToPageItem.Caption
Gradient color		TMainForm: GradientColorAction.Hint	TPropertyEditorForm: Panel26.Caption
Graphics Interchange Format	Graphics Interchange Format	GIFLoader_rsGIFImageFile
Gray	»ÒÉ«	ExtCtrls_clNameGray
Gray Text	Gray Text	ExtCtrls_clNameGrayText
Green	ÂÌÉ«	ExtCtrls_clNameGreen
Grid (%s)	Õ¤¸ñ (%s)	DesignerSetup_rsGridS
GridBox	GridBox	TDesignerSetupForm: GridBox.Caption
Group	×éºÏ(&G)	TMainForm: ActionManager.Caption	TMainForm: GroupAction.Caption
Group must consist of connected lines	×éºÏ±ØÐë°üº¬Á¬½ÓÏß	GroupObject_rsGroupMustConsistOfConnectedLines
Group selected objects	×éºÏÑ¡¶¨µÄ¶ÔÏó	TMainForm: GroupAction.Hint
Group selected objects in metafile object	×éºÏÑ¡¶¨µÄ¶ÔÏóÎªÍ¼Ôª	TMainForm: MakeMetafileAction.Hint
GroupIndex cannot be less than a previous menu item's GroupIndex	GroupIndex cannot be less than a previous menu item's GroupIndex	Consts_SGroupIndexTooLow
Guess undefined	Guess undefined	ExpressionEval_rsGuessUndefined
HTML formatted color	HTML ¸ñÊ½ÑÕÉ«Öµ	TextEditor_rsHTMLFormattedColor
Halftone	È¡ÖÐ¼äÉ«	TPropertyEditorForm: HalftoneCheckBox.Caption
Height	¸ß¶È	TPropertyEditorForm: Panel8.Caption
Height:	¸ß¶È:	TPagePropertiesForm: Label2.Caption
Help	°ïÖú(&H)	TMainForm: ActionManager.Caption	TMainForm: ActionManager.Caption	TMainForm: ActionManager.Caption	TMainForm: HelpMenuAction.Caption
Help Contents	°ïÖúÖ÷Ìâ(&C)	TMainForm: ActionManager.Caption	TMainForm: HelpFileAction.Caption
HelpLabel	HelpLabel	TExpressionEvalForm: HelpLabel.Caption
Highlight Background	¸ßÁÁ±³¾°É«	ExtCtrls_clNameHighlight
Highlight Text	¸ßÁÁÇ°¾°É«	ExtCtrls_clNameHighlightText
Highlight syntax		TTextEditorForm: HighlightSyntaxBox.Caption
Hold Ctrl to draw horizontal or vertical lines only. Alt to ignore grid. Shift to ignore links.		Main_rsEditConnectorHint
Hold Ctrl to keep height and width equal. Alt to ignore grid. Shift to scale around center.		Main_rsEditShapeHint
Home	Home	Consts_SmkcHome
Horizontal	ºáÏò	LinkEditor_rsHorizontal
Horizontal scaling		TPropertyEditorForm: HorzScaleAnchorBox.Hint
Horizontal text alignment	ºáÏòÎÄ±¾¶ÔÆë·½Ê½	TPropertyEditorForm: Panel3.Caption
I would like to thank %s and others for making their software libraries available.	I would like to thank %s and others for making their software libraries available.	Main_rsIWouldLikeToThank
I/O error %d	I/O error %d	SysConst_SInOutError
IO-error: %s	IO-error: %s	Streams_rs_IOError
Icon image is not valid	Icon image is not valid	Consts_SInvalidIcon
Icons	Í¼±ê	Consts_SVIcons
If you like this software then please support my work and the future development of the program, the documentation and the website.#$0DWithout your support keeping the website running is only an expense for me.	If you like this software then please support my work and the future development of the program, the documentation and the website.#$0DWithout your support keeping the website running is only an expense for me.	TPleaseSupportForm: Label1.Caption
Ignore all	È«²¿ºöÂÔ(&I)	TSpellCheckForm: IgnoreAllButton.Caption
Image exceeds Logical Screen size	Image exceeds Logical Screen size	GIFImage_sScreenSizeExceeded
Image has no DIB	Image has no DIB	GIFImage_sNoDIB
Image height too small for contained frames	Image height too small for contained frames	GIFImage_sBadHeight
Image is empty	Image is empty	GIFImage_sEmptyImage
Image is too large for icon	Image is too large for icon	ICOLoader_rsImageIsTooLargeForIcon
Image width too small for contained frames	Image width too small for contained frames	GIFImage_sBadWidth
Inactive Border	Inactive Border	ExtCtrls_clNameInactiveBorder
Inactive Caption	Inactive Caption	ExtCtrls_clNameInactiveCaption
Inactive Caption Text	Inactive Caption Text	ExtCtrls_clNameInactiveCaptionText
Include format description in file views instead of just "XYZ File"	ÔÚ×ÊÔ´ä¯ÀÀÆ÷ÖÐÏÔÊ¾ÎÄ¼þµÄÃèÊö¶ø²»½ö½öÊÇ¼òµ¥µÄ "XXX File"	TFormatAssociateForm: DescriptionBox.Hint
Info Background	Info Background	ExtCtrls_clNameInfoBk
Info Text	Info Text	ExtCtrls_clNameInfoText
InfoLabel	InfoLabel	TAboutBox: InfoLabel.Caption
Information	ÐÅÏ¢	Consts_SMsgDlgInformation
Inner bounds	Inner bounds	TPropertyEditorForm: InnerBoundsBox.Caption
Ins	Ins	Consts_SmkcIns
Insert inherited layer...	²åÈë¸´±¾²ã(&N)...	TMainForm: ActionManager.Caption	TMainForm: InheritLayerAction.Caption
Insert picture from file	´ÓÎÄ¼þ²åÈëÍ¼Ïó	TMainForm: InsertPictureAction.Hint
Insert picture...	²åÈëÍ¼Ïó(&I)...	TMainForm: ActionManager.Caption	TMainForm: InsertPictureAction.Caption
Insert text		TMainForm: DrawTextAction.Caption
Integer overflow	Integer overflow	SysConst_SIntOverflow
Interface not supported	Interface not supported	SysConst_SIntfCastError
Internal error: Extension Instance does not match Extension Label	Internal error: Extension Instance does not match Extension Label	GIFImage_sBadExtensionInstance
Internet help page	Internet °ïÖúÒ³Ãæ	TMainForm: ActionManager.Caption	TMainForm: InternetHelpAction.Caption
Internet:	Internet:	TAboutBox: Label3.Caption
Invalid GIF data	Invalid GIF data	GIFImage_sInvalidData
Invalid GIF signature	Invalid GIF signature	GIFImage_sBadSignature
Invalid Image trailer	Invalid Image trailer	GIFImage_sBadTrailer
Invalid ImageList	Invalid ImageList	Consts_SInvalidImageList
Invalid ImageList Index	Invalid ImageList Index	Consts_SImageIndexError
Invalid NULL variant operation	Invalid NULL variant operation	SysConst_SInvalidVarNullOp
Invalid PNG data	Invalid PNG data	PNGLoader_rsInvalidPNGData
Invalid PNG header	Invalid PNG header	PNGLoader_rsInvalidPNGHeader
Invalid alpha channel format or dimensions		PNGLoader_rsInvalidAlphaChannelFormat
Invalid argument	Invalid argument	SysConst_SVarInvalid
Invalid binary number	Invalid binary number	ExpressionEval_rsInvalidBinaryNumber
Invalid bitmap size	Invalid bitmap size	LinarBitmap_rsInvalidBitmapSize
Invalid buffer size	Invalid buffer size	BufStream_rsInvalidBufferSize
Invalid class typecast	Invalid class typecast	SysConst_SInvalidCast
Invalid clipboard format	Invalid clipboard format	Consts_SInvalidClipFmt
Invalid color index	Invalid color index	GIFImage_sBadColorIndex
Invalid data type for '%s'	Invalid data type for '%s'	RTLConsts_SInvalidRegType
Invalid diagram	ÎÞÐ§µÄÍ¼±í	DiagramBase_rsInvalidDiagram
Invalid extension introducer	Invalid extension introducer	GIFImage_sBadExtensionLabel
Invalid filename	ÎÞÐ§µÄÎÄ¼þÃû	SysConst_SInvalidFilename
Invalid floating point operation	Invalid floating point operation	SysConst_SInvalidOp
Invalid image dimensions	Invalid image dimensions	GIFImage_sBadDimension
Invalid image size	Invalid image size	Consts_SInvalidImageSize
Invalid index	Invalid index	ComStrs_sInvalidIndex
Invalid number format	Invalid number format	ExpressionEval_rsInvalidNumberFormat
Invalid number of colors specified in Image Descriptor	Invalid number of colors specified in Image Descriptor	GIFImage_sImageBadColorSize
Invalid number of colors specified in Screen Descriptor	Invalid number of colors specified in Screen Descriptor	GIFImage_sScreenBadColorSize
Invalid numeric input	Invalid numeric input	SysConst_SInvalidInput
Invalid numeric value	Invalid numeric value	Consts_SInvalidNumber
Invalid owner	Invalid owner	ComStrs_sInvalidOwner
Invalid pixel coordinates	Invalid pixel coordinates	GIFImage_sBadPixelCoordinates
Invalid pixel format	Invalid pixel format	Consts_SInvalidPixelFormat
Invalid pointer operation	Invalid pointer operation	SysConst_SInvalidPointer
Invalid property path	Invalid property path	RTLConsts_SInvalidPropertyPath
Invalid property value	Invalid property value	RTLConsts_SInvalidPropertyValue	RTLConsts_SInvalidProperty
Invalid reduction method	Invalid reduction method	GIFImage_sInvalidReduction
Invalid stream format	Invalid stream format	RTLConsts_SInvalidImage
Invalid stream operation	Invalid stream operation	GIFImage_sInvalidStream
Invalid template palette	ÎÞÐ§µÄÄ£°å	TemplateObjects_rsInvalidTemplatePalette
Invalid variant operation	Invalid variant operation	SysConst_SInvalidVarOp
Invalid variant operation (%s%.8x)\n%s	Invalid variant operation (%s%.8x)\n%s	SysConst_SInvalidVarOpWithHResultWithPrefix
Invalid variant type	Invalid variant type	SysConst_SVarBadType
Invalid variant type conversion	Invalid variant type conversion	SysConst_SInvalidVarCast
Italic	Ð±Ìå	TextEditor_rsItalic
Item %s has subitems, delete anyway?	ÏîÄ¿ %s ÓµÓÐ×ÓÏî£¬È·¶¨É¾³ý£¿	Consts_SDeleteItemWithSubItems
Item %s is not allowed to be moved	ÏîÄ¿ %s ²»ÔÊÐíÒÆ¶¯	Consts_SMoveNotAllowed
JPEG Image File	JPEG Image File	JConsts_sJPEGImageFile
JPEG error #$23%d	JPEG error #$23%d	JConsts_sJPEGError
Jan	Jan	SysConst_SShortMonthNameJan
January	January	SysConst_SLongMonthNameJan
Joint Picture Expert Group	Joint Picture Expert Group	JPEGLoader_rsJPEGImageFile
Jul	Jul	SysConst_SShortMonthNameJul
July	July	SysConst_SLongMonthNameJul
Jun	Jun	SysConst_SShortMonthNameJun
June	June	SysConst_SLongMonthNameJun
Known image formats	ÒÑÖªÍ¼Ïó¸ñÊ½	Main_rsKnownImageFormats
LabelCode1	LabelCode1	TTextEditorForm: LabelCode1.Caption
LabelCode2	LabelCode2	TTextEditorForm: LabelCode2.Caption
LabelDescription1	LabelDescription1	TTextEditorForm: LabelDescription1.Caption
LabelDescription2	LabelDescription2	TTextEditorForm: LabelDescription2.Caption
Language:	ÓïÑÔ:	TSpellCheckForm: Label5.Caption
Last	Ä©Ò³(&L)	TSlideShowForm: LastSlideItem.Caption
Layer		TMainForm: LayerTabSet.Hint
Layer %d		Main_rsLayerD
Layer &1	µÚ &1 ²ã	TMainForm: EditLayer1Action.Caption
Layer &2	µÚ &2 ²ã	TMainForm: EditLayer2Action.Caption
Layer &3	µÚ &3 ²ã	TMainForm: EditLayer3Action.Caption
Layer number:	²ãºÅ:	Main_rsLayerNumber
Layout	²¼¾Ö	TPropertyEditorForm: Panel18.Caption
Left	×ó¶ÔÆë(&L)	Consts_SmkcLeft	TMainForm: ActionManager.Caption	TMainForm: AlignLeftAction.Caption	TPropertyEditorForm: Panel11.Caption	TPropertyEditorForm: LeftAnchorBox.Hint
Left click to set		Main_rsLeftClickToSet
Left#$0DCenter#$0DRight#$0DBlock left#$0DBlock right#$0D	Left#$0DCenter#$0DRight#$0DBlock left#$0DBlock right#$0D	TPropertyEditorForm: TextXAlignBox.Items.Strings
Left+right click to add point		Main_rsLeftRightClickToAddPoint
Legacy		PropertyEditor_rsLegacy
Lime	Lime	ExtCtrls_clNameLime
Line color	ÏßÌõÑÕÉ«	TMainForm: LineColorAction.Hint	TPropertyEditorForm: Panel7.Caption
Line end	ÏßÌõÖÕµã	TMainForm: LineEndAction.Hint	TPropertyEditorForm: Panel13.Caption
Line segments		PropertyEditor_rsLineSegments
Line start	ÏßÌõÆðµã	TMainForm: LineStartAction.Hint	TPropertyEditorForm: Panel12.Caption
Line style	ÏßÌõ·ç¸ñ	TPropertyEditorForm: Panel20.Caption
Line width	ÏßÌõ¿í¶È	Main_rsLineWidth	TMainForm: LineWidthAction.Hint	TPropertyEditorForm: Panel5.Caption
Link point editor	¶¥µã±à¼­	TLinkEditorForm: LinkEditorForm.Caption
Link positions	¶¥µãÎ»ÖÃ	TPropertyEditorForm: BoundsPanel.Caption
List capacity out of bounds (%d)	List capacity out of bounds (%d)	RTLConsts_SListCapacityError
List count out of bounds (%d)	List count out of bounds (%d)	RTLConsts_SListCountError
List does not allow duplicates ($0%x)	List does not allow duplicates ($0%x)	RTLConsts_SDuplicateItem
List index out of bounds (%d)	List index out of bounds (%d)	StringLists_rsListIndexError	RTLConsts_SListIndexError
Listbox (%s) style must be virtual in order to set Count	Listbox (%s) style must be virtual in order to set Count	Consts_SListBoxMustBeVirtual
Load template palette	¶ÁÈëÄ£°å(&L)	TMainForm: LoadTemplatePaletteMenu.Caption
Load template palette from library		TMainForm: LoadTemplatePaletteMenu.Hint
Load template palette...	¶ÁÈëÄ£°å(&L)...	TMainForm: ActionManager.Caption	TMainForm: LoadTemplateAction.Caption
Loading...	Loading...	GIFImage_sProgressLoading	DialogsEx_rsLoading
Look up:	²é¿´:	TSpellCheckForm: LookUpLabel.Caption
MainForm	MainForm	TMainForm: MainForm.Caption
Make palette from active layer	±£´æµ±Ç°²ãÎªÄ£°å(&M)	TMainForm: ActionManager.Caption	TMainForm: PageToTemplateAction.Caption
Many		LineObject_rsMany
Mar	Mar	SysConst_SShortMonthNameMar
March	March	SysConst_SLongMonthNameMar
Margin for non-centered text	Õë¶Ô·Ç¾ÓÖÐÎÄ±¾µÄ±ß¾à	TPropertyEditorForm: Panel21.Hint
Maroon	Maroon	ExtCtrls_clNameMaroon
Max 16 bits in binary number	Max 16 bits in binary number	ExpressionEval_rsMax16BitsInBinaryNumber
Max=	Max=	TExpressionPlotForm: Label2.Caption
Maximum number of undos/redos	³·Ïû/ÖØ¸´ ×î´ó´ÎÊý	TDesignerSetupForm: UndoHistoryEdit.Hint
May	May	SysConst_SLongMonthNameMay	SysConst_SShortMonthNameMay
Medium Gray	Medium Gray	ExtCtrls_clNameMedGray
Menu		TQuickMenuSearchForm: ListView.Caption
Menu '%s' is already being used by another form	Menu '%s' is already being used by another form	Consts_SDuplicateMenus
Menu Background	Menu Background	ExtCtrls_clNameMenu
Menu Text	Menu Text	ExtCtrls_clNameMenuText
Menu index out of range	Menu index out of range	Consts_SMenuIndexError
Menu inserted twice	Menu inserted twice	Consts_SMenuReinserted
Menu search		TQuickMenuSearchForm: QuickMenuSearchForm.Caption
Metafile	Metafile	TPropertyEditorForm: Panel17.Caption
Metafile is not valid	Metafile is not valid	Consts_SInvalidMetafile
Metafiles	Metafiles	Consts_SVMetafiles
Michael Vinther	Michael Vinther	TAboutBox: Label1.Caption
Millimeters#$0DCentimeters#$0DInches#$0Dpoints#$0D300 DPI dots#$0D600 DPI dots#$0D	ºÁÃ×#$0DÀåÃ×#$0DÓ¢´ç#$0DÏñËØ#$0D300 DPI#$0D600 DPI#$0D	TDesignerSetupForm: UnitsBox.Items.Strings
Min=	Min=	TExpressionPlotForm: Label3.Caption
Minimum value for expression in x	Minimum value for expression in x	ExpressionEval_rsMinimumValueForExpressionInX
Mirror	¾µÏó(&M)	TMainForm: ActionManager.Caption	TMainForm: FlipLRAction.Caption
Mon	Mon	SysConst_SShortDayNameMon
Monday	Monday	SysConst_SLongDayNameMon
Money Green	Money Green	ExtCtrls_clNameMoneyGreen
More Buttons	More Buttons	Consts_SMoreButtons
Move canvas	ä¯ÀÀ	TMainForm: MoveCanvasAction.Caption
MultiLine must be True when TabPosition is tpLeft or tpRight	MultiLine must be True when TabPosition is tpLeft or tpRight	ComStrs_sTabMustBeMultiLine
Multiple-image Network Graphics	Multiple-image Network Graphics	PNGLoader_rsMNGImageFile
Multiselect mode must be on for this feature	Multiselect mode must be on for this feature	Consts_SMultiSelectRequired
N&o to All	È«²¿Ñ¡·ñ(&N)	Consts_SMsgDlgNoToAll
Name	Ãû³Æ	TPropertyEditorForm: Panel1.Caption
Name expected	Name expected	ExpressionEval_rsNameExpected
Navy	Navy	ExtCtrls_clNameNavy
New diagram	ÐÂ½¨Í¼±í	TMainForm: NewAction.Hint
New line	»»ÐÐ	TextEditor_rsNewLine
New page	ÐÂ½¨Ò³Ãæ(&N)	TMainForm: ActionManager.Caption	TMainForm: NewPageAction.Caption
New...	ÐÂ½¨(&N)...	TMainForm: ActionManager.Caption	TMainForm: NewAction.Caption
Next	ÏÂÒ»Ò³(&N)	TSlideShowForm: NextSlideItem.Caption
No ActionBand style unit present in the uses clause.\rYour application must include either XPStyleActnCtrls, StdStyleActnCtrls or a third party ActionBand style unit in its uses clause.	No ActionBand style unit present in the uses clause.\rYour application must include either XPStyleActnCtrls, StdStyleActnCtrls or a third party ActionBand style unit in its uses clause.	Consts_SActionBarStyleMissing
No OnGetItem event handler assigned	No OnGetItem event handler assigned	Consts_SNoGetItemEventHandler
No argument for format '%s'	No argument for format '%s'	SysConst_SArgumentMissing
No context-sensitive help installed	No context-sensitive help installed	HelpIntfs_hNoContext
No dictionaries installed or dictionary path not set in the Options dialog.	Î´°²×°´ÊµäÎÄ¼þ/Î´ÉèÖÃ´ÊµäÎÄ¼þÂ·¾¶	Main_rsNoDictionariesFound
No files found		Main_rsNoFilesFound
No global or local color table defined	No global or local color table defined	GIFImage_sNoColorTable
No help found for %s	No help found for %s	HelpIntfs_hNothingFound
No help keyword specified.	No help keyword specified.	WinHelpViewer_hNoKeyword
No icons in file	No icons in file	ICOLoader_rsNoIconsInFile
No more points allowed	ÒÑ´ïµ½¿É¶¨Òå¶¥µãÊýÄ¿ÉÏÏÞ	LineObject_rsNoMorePointsAllowed
No objects in active layer	µ±Ç°²ãÖÐÎÞ¶ÔÏó	Main_rsNoObjectsInActiveLayer
No solution found, try changing starting guess	No solution found, try changing starting guess	ExpressionEval_rsNoSolutionFoundTryChangingStartingGuess
No topic-based help system installed	No topic-based help system installed	HelpIntfs_hNoTopics
No version-info was associated with the requested file \"%s\"	No version-info was associated with the requested file \"%s\"	VersionInfo_rs_noversioninfo
None	None	ColorDialog_rsNone	LineObject_rsNone	ExtCtrls_clNameNone
Not enough timers available	Not enough timers available	Consts_SNoTimers
Not in dictionary:	²»ÔÚ´ÊµäÖÐ:	SpellChecker_rsNotInDictionary
Note that closing tags are not required		TTextEditorForm: Label3.Caption
Note that this action cannot be undone, and file format registrations will NOT be restored to the previous setting if the program is uninstalled.	×¢Òâ£º¸Ã²Ù×÷ÎÞ·¨³·Ïû£¬²¢ÇÒ£¬ÔÚÐ¶ÔØ±¾³ÌÐòÖ®ºóÒÑ×¢²áµÄÎÄ¼þ¸ñÊ½ÎÞ·¨»Ö¸´¡£	TFormatAssociateForm: Label1.Caption
Note that writing of files with multiple icons is not supported.	×¢Òâ£º²»Ö§³ÖÐ´Èë°üº¬¶à¸öÍ¼±êµÄÎÄ¼þ¡£	TIconSelectionForm: Label1.Caption
Nov	Nov	SysConst_SShortMonthNameNov
November	November	SysConst_SLongMonthNameNov
OK	È·¶¨(&O)	TFormatAssociateForm: AssociateButton.Caption	TLanguageSelectorForm: OKButton.Caption	TAboutBox: OKButton.Caption	TIconSelectionForm: OkButton.Caption	TDesignerSetupForm: Button2.Caption	Consts_SMsgDlgOK	Consts_SOKButton	TLinkEditorForm: Button2.Caption	TPagePropertiesForm: OKBtn.Caption	TPasteSpecialForm: OKBtn.Caption	TPropertyEditorForm: OkButton.Caption	TRearrangePagesForm: OKButton.Caption	TTextEditorForm: OKButton.Caption
Object	¶ÔÏó(&O)	TMainForm: ActionManager.Caption	TMainForm: ObjectMenuAction.Caption
Object properties	¶ÔÏóÊôÐÔ	TMainForm: PropertiesAction.Hint
Object type not supported for operation	Object type not supported for operation	GIFImage_sUnsupportedClass
Object:	¶ÔÏó:	TSpellCheckForm: Label2.Caption
Objects cast shadows		TMainForm: ActionManager.Caption	TMainForm: ObjectShadowsAction.Caption
Objects in this layer are visible in all pages		TMainForm: EditStencilAction.Hint
Oct	Oct	SysConst_SShortMonthNameOct
October	October	SysConst_SLongMonthNameOct
Odd rounded 1	Odd rounded 1	FlowchartObject_rsOddRounded1
Odd rounded 2	Odd rounded 2	FlowchartObject_rsOddRounded2
Olive	Olive	ExtCtrls_clNameOlive
Opacity		TPropertyEditorForm: Panel24.Caption
Open	´ò¿ª	Main_rsOpen
Open in new window...	ÔÚÐÂ´°¿ÚÖÐ´ò¿ª(&I)...	TMainForm: ActionManager.Caption	TMainForm: OpenNewAction.Caption
Open...	´ò¿ª(&O)...	TMainForm: ActionManager.Caption	TMainForm: ActionManager.Caption	TMainForm: ActionManager.Caption	TMainForm: OpenAction.Caption
Operation aborted	²Ù×÷ÒÑÖÐ¶Ï	SysConst_SOperationAborted
Operation not allowed on sorted list	Operation not allowed on sorted list	RTLConsts_SSortedListError
Operation not allowed on sorted string list	Operation not allowed on sorted string list	StringLists_rsSortedListError
Operation not supported	Operation not supported	AnalyzerPlugins_rsOperationNotSupported	SysConst_SVarNotImplemented
Operation not supported on selected printer	Operation not supported on selected printer	Consts_SInvalidPrinterOp
Operator expected	Î´·¢ÏÖ²Ù×÷·û	ExpressionEval_rsOperatorExpected
Operators:\n&\tLogical AND\n|\tLogical OR\n=\tEqual\n#$23\tNot equal\n>\tGreater\n<\tLess\n+\tAdd\n-\tSubtract\n*\tMultiply\n/\tDivide\n%\tModulus\n^\tPower\n\nDefining symbols:\n:Name = Value;\n:Func(x) = Expression;	²Ù×÷·û:\n&\tÂß¼­Óë\n|\tÂß¼­»ò\n=\tµÈÓÚ\n#$23\t²»µÈÓÚ\n>\t´óÓÚ\n<\tÐ¡ÓÚ\n+\t¼Ó\n-\t¼õ\n*\t³Ë\n/\t³ý\n%\tÈ¡Ä£\n^\tn´Î·½\n\n¶¨Òå·û:\n:Name = Value;\n:Func(x) = Expression;	ExpressionHelp_rsExpressionHelp
Optimizing...	Optimizing...	GIFImage_sProgressOptimizing
Options	Ñ¡Ïî	TDesignerSetupForm: DesignerSetupForm.Caption	TMainForm: ActionManager.Caption	TMainForm: OptionsAction.Caption
Out of memory	Out of memory	SysConst_SOutOfMemory
Out of memory while expanding memory stream	Out of memory while expanding memory stream	RTLConsts_SMemoryStreamError
Out of system resources	Out of system resources	Consts_SOutOfResources
Overflow while converting variant of type (%s) into type (%s)	Overflow while converting variant of type (%s) into type (%s)	SysConst_SVarTypeConvertOverflow
Overline	ÉÏ»®Ïß	TextEditor_rsOverline
Overwrite template palette contents with objects from active layer?	ÊÇ·ñÓÃµ±Ç°²ãÖÐµÄ¶ÔÏó¸²¸ÇÄ£°åÄÚÈÝ£¿	Main_rsOverwriteTemplatePaletteContentsWithObjectsFromActiveLayer
Page		TMainForm: PageTabSet.Hint
Page %d	µÚ %d Ò³	DiagramBase_rsPageD
Page count		TextEditor_rsPageCount
Page number	Ò³Âë	TextEditor_rsPageNumber
Page number:	Ò³Âë:	SlideShow_rsPageNumber
Page p%s layer %d	Ò³Âë p%s ²ã %d 	PictureObject_rsPagePSLayerD
Page properties	Ò³ÃæÊôÐÔ	TPagePropertiesForm: PagePropertiesForm.Caption
Page properties...	Ò³ÃæÊôÐÔ(&P)...	TMainForm: ActionManager.Caption	TMainForm: PagePropertiesAction.Caption
Page title	Ò³Ãæ±êÌâ	TextEditor_rsPageTitle
Page title (empty for auto):	Ò³Ãæ±êÌâ(ÖÃ¿Õ×Ô¶¯ÃüÃû):	RearrangePages_rsPageTitleEmptyForAuto
Parent given is not a parent of '%s'	Parent given is not a parent of '%s'	Consts_SParentGivenNotAParent
Paste	Õ³Ìù(&P)	TMainForm: ActionManager.Caption	TMainForm: ActionManager.Caption	TMainForm: ActionManager.Caption	TMainForm: ActionManager.Caption	TMainForm: PasteAction.Caption
Paste special	Ñ¡ÔñÐÔÕ³Ìù(&A)	TMainForm: ActionManager.Caption	TMainForm: PasteSpecialAction.Caption	TPasteSpecialForm: PasteSpecialForm.Caption
PgDn	PgDn	Consts_SmkcPgDn
PgUp	PgUp	Consts_SmkcPgUp
Please support %s	ÇëÖ§³Ö %s	TPleaseSupportForm: PleaseSupportForm.Caption
Plot graph of expression in x	Plot graph of expression in x	ExpressionPlot_rsPlotGraphOfExpressionInX
Plot of	Plot of	TExpressionPlotForm: ExpressionPlotForm.Caption
Polygon must have at least two points	±ØÐëÎª¶à±ßÐÎ¶¨ÒåÖÁÉÙÁ½¸ö¶¥µã	GroupObject_rsPolygonMustHaveAtLeastTwoPoints
Popup note		TextEditor_rsPopupNote
Portable Network Graphics	Portable Network Graphics	PNGLoader_rsPNGImageFile
Premature end of data	Premature end of data	GIFImage_sOutOfData
Preview mode	Ô¤ÀÀÄ£Ê½(&V)	TMainForm: ActionManager.Caption	TMainForm: PrintPreviewAction.Caption
Preview not available	Ô¤ÀÀ²»¿ÉÓÃ	DialogsEx_rsPreviewNotAvailable
Previous	Ç°Ò»¸ö(&P)	TSlideShowForm: PreviousSlideItem.Caption
Print as bitmap		TDesignerSetupForm: PrintAsBitmapBox.Caption
Print scaling set to %d%%		PrintDiagram_rsPrintScalingSetToD
Print scaling:		TDesignerSetupForm: Label7.Caption
Print...	´òÓ¡(&T)...	TMainForm: ActionManager.Caption	TMainForm: PrintAction.Caption
Printer is not currently printing	´òÓ¡»ú´¦ÓÚ¿ÕÏÐ×´Ì¬	Consts_SNotPrinting
Printer selected is not valid	Ñ¡¶¨µÄ´òÓ¡»úÎÞÐ§	Consts_SInvalidPrinter
Printing in progress	ÕýÔÚ´òÓ¡	Consts_SPrinting
Privileged instruction	Privileged instruction	SysConst_SPrivilege
Process failed: %d	Process failed: %d	AnalyzerPlugins_rsProcessFailedD
ProductName	ProductName	TAboutBox: ProductName.Caption
Program must be restarted for changes to take effect.	ÇëÖØÐÂÆô¶¯³ÌÐòÒÔÊ¹ÉèÖÃÉúÐ§¡£	LanguageSelector_rsProgramMustBeRestartedForChangesToTakeEffect
Properties	ÊôÐÔ	TMainForm: TemplatePropertiesAction.Caption	TPropertyEditorForm: PropertyEditorForm.Caption
Properties...	ÊôÐÔ(&P)...	TMainForm: ActionManager.Caption	TMainForm: PropertiesAction.Caption
Property %s does not exist	ÊôÐÔÖµ %s ²»´æÔÚ	RTLConsts_SUnknownProperty
Property is read-only	ÊôÐÔÖµÎªÖ»¶Á	RTLConsts_SReadOnlyProperty
Purple	Purple	ExtCtrls_clNamePurple
Radius of corner arc		TPropertyEditorForm: Panel22.Hint	TPropertyEditorForm: Panel24.Hint
Random number in [0;x[	Random number in [0;x[	ExpressionEval_rsRandomNumberIn0X
Range check error	Range check error	SysConst_SRangeError
Range:	·¶Î§:	TExpressionPlotForm: Label1.Caption
Read	Read	SysConst_SReadAccess
Read beyond end of file	Read beyond end of file	SysConst_SEndOfFile
Read less than expected	Read less than expected	Streams_rs_ReadLessError
Rearrange pages	ÖØÐÂÅÅÁÐÒ³Ãæ	TRearrangePagesForm: RearrangePagesForm.Caption
Rearrange pages...	ÖØÐÂÅÅÁÐÒ³Ãæ(&R)...	TMainForm: ActionManager.Caption	TMainForm: ReorderPagesAction.Caption
Recursive reference	Recursive reference	ExpressionEval_rsRecursiveReference
Red	Red	ExtCtrls_clNameRed
Redo	ÖØ¸´(&R)	Main_rsRedo	TMainForm: ActionManager.Caption	TMainForm: RedoAction.Caption
Relative page number (-1 = previous page):	Ïà¶ÔÒ³Âë(-1 = Ç°Ò»Ò³):	Main_rsRelativePageNumber1PreviousPage
Reload	ÖØÐÂ¼ÓÔØ(&R)	TMainForm: ActionManager.Caption	TMainForm: ActionManager.Caption	TMainForm: ReloadAction.Caption
Reload and lose changes?	ÖØÐÂ¼ÓÔØ½«¶ªÊ§ËùÓÐ±ä¸ü£¬ÊÇ·ñ¼ÌÐø£¿	Main_rsReloadAndLoseChanges
Rename	ÖØÃüÃû(&R)	TRearrangePagesForm: RenameButton.Caption
Render all objects to a bit and print the bitmap. This may be necessary with some printers to handle transparency and gradient fill correctly.		TDesignerSetupForm: PrintAsBitmapBox.Hint
Rendering...	Rendering...	GIFImage_sProgressRendering
Reorder or delete pages	ÖØÐÂÅÅÐò/É¾³ýÒ³Ãæ	TMainForm: ReorderPagesAction.Hint
Replace	Ìæ»»(&R)	TSpellCheckForm: ReplaceButton.Caption
Reset Toolbar	ÖØÖÃ¹¤¾ßÀ¸	Consts_SResetActionToolBar
Reset symbol table	ÖØÖÃ·ûºÅ±í	TExpressionEvalForm: ActionResetSymbols.Caption
Resource %s not found	Î´ÕÒµ½×ÊÔ´ %s	RTLConsts_SResNotFound
RichEdit line insertion error	RichEdit line insertion error	ComStrs_sRichEditInsertError
Right	ÓÒ¶ÔÆë(&R)	Consts_SmkcRight	TMainForm: ActionManager.Caption	TMainForm: AlignRightAction.Caption	TPropertyEditorForm: RightAnchorBox.Hint
Right click to clear		Main_rsRightClickToClear
Root of expression in x	Root of expression in x	ExpressionEval_rsRootOfExpressionInX
Rotate	Ðý×ª(&R)	Main_rsRotate	TMainForm: ActionManager.Caption	TMainForm: RotateMenuAction.Caption	TMainForm: Rotate1.Caption
Rotate 180°	Ðý×ª 180 ¶È(&O)	TMainForm: ActionManager.Caption	TMainForm: Rotate180Action.Caption
Rotate 270°	Ðý×ª 270 ¶È(&T)	TMainForm: ActionManager.Caption	TMainForm: Rotate270Action.Caption
Rotate 90°	Ðý×ª 90 ¶È(&R)	TMainForm: ActionManager.Caption	TMainForm: Rotate90Action.Caption
Rotate selected objects counter-clockwise. Note that not all object types support this operation.	ÄæÊ±ÕëÐý×ªÑ¡¶¨µÄ¶ÔÏó¡£ËùÓÐÀàÐÍ¶ÔÏó¶¼Ö§³Ö¸Ã²Ù×÷¡£	TMainForm: RotateAction.Hint
Rotation angle	Ðý×ª½Ç¶È	Main_rsRotationAngle	TPropertyEditorForm: Panel19.Caption
Round to nearest integer	Round to nearest integer	ExpressionEval_rsRoundToNearestInteger
Rounded 1	Rounded 1	FlowchartObject_rsRounded1
Rounded 2	Rounded 2	FlowchartObject_rsRounded2
Rounded 3	Rounded 3	FlowchartObject_rsRounded3
Rounds toward negative infinity	Rounds toward negative infinity	ExpressionEval_rsRoundsTowardNegativeInfinity
Rounds up toward positive infinity	Rounds up toward positive infinity	ExpressionEval_rsRoundsUpTowardPositiveInfinity
Sat	Sat	SysConst_SShortDayNameSat
Saturday	Saturday	SysConst_SLongDayNameSat
Save	±£´æ(&S)	TMainForm: ActionManager.Caption	TMainForm: ActionManager.Caption	TMainForm: ActionManager.Caption	TMainForm: SaveAction.Caption
Save as...	Áí´æÎª(&A)...	TMainForm: ActionManager.Caption	TMainForm: SaveAsAction.Caption
Save template palette...	±£´æÄ£°å(&S)...	TMainForm: ActionManager.Caption	TMainForm: SaveTemplateAction.Caption
Saving...	Saving...	GIFImage_sProgressSaving
Scan line index out of range	Scan line index out of range	Consts_SScanLine
Scroll Bar	Scroll Bar	ExtCtrls_clNameScrollBar
Scrollbar property out of range	Scrollbar property out of range	Consts_SScrollBarRange
Seeking not supported	Seeking not supported	DelphiStream_rsSeekingNotSupported
Select all	È«Ñ¡(&S)	TFormatAssociateForm: AllButton.Caption	TMainForm: ActionManager.Caption	TMainForm: SelectAllAction.Caption
Select clipboard format:	Ñ¡Ôñ¼ôÌù°å¸ñÊ½:	TPasteSpecialForm: Label1.Caption
Select icon to import from file	ÇëÑ¡ÔñÒªµ¼ÈëµÄÍ¼±ê	TIconSelectionForm: IconSelectionForm.Caption
Select program language	Ñ¡ÔñÓïÑÔ	TLanguageSelectorForm: LanguageSelectorForm.Caption
Send bug report		StyleForm_rsSendBugReport
Send to back	½µµÍÏÔÊ¾ÓÅÏÈ¼¶(&S)	TMainForm: ActionManager.Caption	TMainForm: SendToBackAction.Caption
Sep	Sep	SysConst_SShortMonthNameSep
Separator	Separator	Consts_SSeparator
Separator line		TextEditor_rsSeparatorLine
September	September	SysConst_SLongMonthNameSep
Set		TPropertyEditorForm: ColorKeyButton.Caption
Set diagram font	ÉèÖÃÍ¼±í×ÖÌå	TMainForm: DiagramFontAction.Hint
Set dictionary path	ÉèÖÃ´ÊµäÎÄ¼þÂ·¾¶	TDesignerSetupForm: DictionaryPathButton.Caption
Set font by name	ÉèÖÃ×ÖÌåÃû³Æ	TextEditor_rsSetFontByName
Set layer color...	ÉèÖÃÍ¼²ãÑÕÉ«(&S)...	TMainForm: ActionManager.Caption	TMainForm: SetLayerColorAction.Caption
Set program language	ÉèÖÃÓïÑÔ	TDesignerSetupForm: LanguageButton.Caption
Shift+	Shift+	Consts_SmkcShift
Show grid	ÏÔÊ¾Íø¸ñÏß(&G)	TDesignerSetupForm: ShowGridBox.Caption
Show object tree	ÏÔÊ¾¶ÔÏóÊ÷(&H)	TMainForm: ActionManager.Caption	TMainForm: ShowTreeAction.Caption
Show printer margins		TDesignerSetupForm: ShowMarginsBox.Caption
Show printer margins on page in designer		TDesignerSetupForm: ShowMarginsBox.Hint
Show this message on startup	Æô¶¯Ê±ÏÔÊ¾¸ÃÐÅÏ¢	TPleaseSupportForm: CheckBox1.Caption
Side bars	²à±ßÀ¸	FlowchartObject_rsSideBars
Silver	Silver	ExtCtrls_clNameSilver
Size of design when pasting from clipboard to other application	´Ó¼ôÌù°å¿½±´µ½ÆäËû³ÌÐòÊ±µÄÍ¼±í³ß´ç¡£	TDesignerSetupForm: ClipboardScaleEdit.Hint
Size of print relative to design size		TDesignerSetupForm: PrintScalingEdit.Hint
Skip	ºöÂÔ	FormatAssociation_rsSkip
Skip symbols	ºöÂÔ·ûºÅ	TSpellCheckForm: SkipSymbolsBox.Caption
Skip words with numbers, single letters and upper case words	ºöÂÔ°üº¬Êý×ÖµÄ´Ê¡¢µ¥¸ö×ÖÄ¸ºÍ´óÐ´´ÊÓï¡£	TSpellCheckForm: SkipSymbolsBox.Hint
Sky Blue	Sky Blue	ExtCtrls_clNameSkyBlue
Slant left	Ïò×óÇãÐ±	FlowchartObject_rsSlantLeft
Slant right	ÏòÓÒÇãÐ±	FlowchartObject_rsSlantRight
Slide show	»ÃµÆÆ¬(&L)	TMainForm: ActionManager.Caption	TMainForm: SlideShowAction.Caption	TSlideShowForm: SlideShowForm.Caption
Solid#$0D·················#$0D· · · · · · · · ·#$0D-----------------#$0D- - - - - - - - -#$0D-- -- -- -- -- --#$0D--  --  --  --  -#$0D-·-·-·-·-·-·-·-·-#$0D--·--·--·--·--·--#$0D-- - -- - -- - --#$0D========#$0D		TPropertyEditorForm: LineStyleBox.Items.Strings
Solve equation in x	Solve equation in x	ExpressionEval_rsSolveEquationInX
Space	Space	Consts_SmkcSpace
Spell check	Æ´Ð´¼ì²é	TSpellCheckForm: SpellCheckForm.Caption
Spell check complete.	Æ´Ð´¼ì²éÒÑÍê³É¡£	SpellChecker_rsSpellCheckComplete
Spell checker...	Æ´Ð´¼ì²é(&L)...	TMainForm: ActionManager.Caption	TMainForm: SpellCheckAction.Caption
Square root	Square root	ExpressionEval_rsSquareRoot
Stack overflow	Stack overflow	SysConst_SStackOverflow
Standard function	Standard function	ExpressionHelp_rsStandardFunction
Stop	Í£Ö¹(&S)	LineObject_rsStop	TSpellCheckForm: StopButton.Caption
Stream not open for write	Stream not open for write	Deflate_rsWriteDenied
Stream read error	Stream read error	RTLConsts_SReadError
Stream write error	Stream write error	RTLConsts_SWriteError
Strikeout		TextEditor_rsStrikeout
String list does not allow duplicates	String list does not allow duplicates	StringLists_rsDuplicateString	RTLConsts_SDuplicateString
Style	·ç¸ñ	TPropertyEditorForm: TabSheet2.Caption
Sub-menu is not in menu	Sub-menu is not in menu	Consts_SMenuNotFound
Subscript	ÏÂ±ê	TextEditor_rsSubscript
Suggestions:	½¨Òé:	TSpellCheckForm: Label4.Caption
Sun	Sun	SysConst_SShortDayNameSun
Sunday	Sunday	SysConst_SLongDayNameSun
Superscript	ÉÏ±ê	TextEditor_rsSuperscript
Support Diagram Designer...	Ö§³Ö Diagram Designer ...	TMainForm: ActionManager.Caption	TMainForm: SupportAction.Caption
Symbol	·ûºÅ	TExpressionEvalForm: ListView.Caption
Symbol font	·ûºÅ×ÖÌå	TextEditor_rsSymbolFont
System Error.  Code: %d.\r\n%s	ÏµÍ³´íÎó¡£´íÎó´úÂë: %d.\r\n%s	SysConst_SOSError
Tab	Tab	Consts_SmkcTab
Tab index out of bounds		Consts_SInvalidTabIndex
Tab position incompatible with current tab style	Tab position incompatible with current tab style	Consts_SInvalidTabPosition
Tab style incompatible with current tab position	Tab style incompatible with current tab position	Consts_SInvalidTabStyle
Teal	Teal	ExtCtrls_clNameTeal
Template palette	Ä£°åÃæ°å(&M)	TMainForm: ActionManager.Caption	TMainForm: TemplatePaletteMenuAction.Caption
Template palette - drag objects from here to diagram	Ä£°åÃæ°å - ´Ó´Ë´¦ÍÏ·Å¶ÔÏóµ½Í¼±í	TMainForm: TemplateScrollBox.Hint
Terminate application		StyleForm_rsTerminateApplication
Text	ÎÄ±¾	Main_rsText	TPropertyEditorForm: Panel2.Caption
Text color	ÎÄ×ÖÑÕÉ«	TMainForm: TextColorAction.Hint	TPropertyEditorForm: Panel14.Caption
Text exceeds memo capacity	ÎÄ±¾¿é´óÐ¡³¬³ö·¶Î§	Consts_SInvalidMemoSize
Text formatting codes:	ÎÄ±¾¸ñÊ½»¯±êÊ¶·û:	TTextEditorForm: Label1.Caption
Text margin	ÎÄ×Ö±ß¾à	TPropertyEditorForm: Panel21.Caption
Text not found		Main_rsTextNotFound
Text:	ÎÄ×Ö:	TSpellCheckForm: Label3.Caption
There is no default printer currently selected	Ã»ÓÐÑ¡¶¨Ä¬ÈÏµÄ´òÓ¡»ú	Consts_SNoDefaultPrinter
This control requires version 4.70 or greater of COMCTL32.DLL	¸Ã×é¼þÐèÒª COMCTL32.DLL 4.70 °æ±¾¼°ÒÔÉÏ·½ÄÜÕý³£¹¤×÷¡£	ComStrs_sInvalidComCtl32
Thread Error: %s (%d)	Thread Error: %s (%d)	RTLConsts_SThreadError
Thread creation error: %s	Thread creation error: %s	RTLConsts_SThreadCreateError
Three-digit font size	ÈýÎ»Êý×ÖÌå´óÐ¡	TextEditor_rsThreeDigitFontSize
Thu	Thu	SysConst_SShortDayNameThu
Thursday	Thursday	SysConst_SLongDayNameThu
Title		TQuickMenuSearchForm: ListView.Caption
Too few lines to create polygon	Ö±ÏßÊýÄ¿¹ýÉÙ£¬²»ÄÜ´´½¨¶à±ßÐÎ¡£	GroupObject_rsTooFewLinesToCreatePolygon
Too many open files	´ò¿ªÎÄ¼þÊýÄ¿¹ý¶à	SysConst_STooManyOpenFiles
Top	¶¥¶Ë¶ÔÆë(&T)	TMainForm: ActionManager.Caption	TMainForm: AlignTopAction.Caption	TPropertyEditorForm: Panel10.Caption	TPropertyEditorForm: TopAnchorBox.Hint
Top#$0DCenter#$0DBottom#$0D	¶¥¶Ë¶ÔÆë#$0D¾ÓÖÐ#$0Dµ×²¿¶ÔÆë#$0D	TPropertyEditorForm: TextYAlignBox.Items.Strings
Transparent color	Í¸Ã÷É«	TIconSelectionForm: TransparentButton.Caption
Transparent color key		TPropertyEditorForm: Panel25.Caption
Tue	Tue	SysConst_SShortDayNameTue
Tuesday	Tuesday	SysConst_SLongDayNameTue
Turn mouse wheel to change		Main_rsUseMouseWheelToChange
Turn mouse wheel to change size		Main_rsUseMouseWheelToChangeSize
UML has a		LineObject_rsUMLHasA
UML is a		LineObject_rsUMLIsA
Unable to Replace Image	Unable to Replace Image	Consts_SReplaceImage
Unable to close file	ÎÞ·¨¹Ø±ÕÎÄ¼þ	AnalyzerPlugins_rsUnableToCloseFile
Unable to create directory	Unable to create directory	SysConst_SCannotCreateDir
Unable to evaluate guess:	Unable to evaluate guess:	ExpressionEval_rsUnableToEvaluateGuess
Unable to find a Table of Contents	Unable to find a Table of Contents	HelpIntfs_hNoTableOfContents
Unable to insert a line	ÎÞ·¨²åÈëÖ±Ïß	Consts_SInsertLineError
Unable to insert an item	ÎÞ·¨²åÈëÏîÄ¿	ComStrs_sInsertError
Unable to open file	ÎÞ·¨´ò¿ªÎÄ¼þ	AnalyzerPlugins_rsUnableToOpenFile
Unable to save settings	ÎÞ·¨±£´æÉèÖÃ	Consts_SUnableToSaveSettings
Undefined	Î´¶¨Òå	ExpressionEval_rsUndefined
Undefined symbol:	Î´¶¨ÒåµÄ·ûºÅ:	ExpressionEval_rsUndefinedSymbol
Underline	ÏÂ»®Ïß	TextEditor_rsUnderline
Undo	³·Ïû	Main_rsUndo	TMainForm: ActionManager.Caption	TMainForm: UndoAction.Caption
Undo history size:	×î´ó³·Ïû´ÎÊý:	TDesignerSetupForm: Label3.Caption
Unexpected character:	Unexpected character:	ExpressionEval_rsUnexpectedCharacter
Unexpected variant error	Unexpected variant error	SysConst_SVarUnexpected
Ungroup	´òÉ¢(&U)	TMainForm: ActionManager.Caption	TMainForm: UngroupAction.Caption
Ungroup active object	´òÉ¢µ±Ç°¶ÔÏó	TMainForm: UngroupAction.Hint
UnitLabel1	UnitLabel1	TPagePropertiesForm: UnitLabel1.Caption
UnitLabel2	UnitLabel2	TPagePropertiesForm: UnitLabel2.Caption
Units:	µ¥Î»:	TDesignerSetupForm: Label5.Caption
Unknown GIF block type	Unknown GIF block type	GIFImage_sBadBlock
Unknown extension type	Unknown extension type	GIFImage_sUnknownExtension
Unknown seek origin	Unknown seek origin	DelphiStream_rsUnknownSeekOrigin
Unsupported Application Extension block size	Unsupported Application Extension block size	GIFImage_sBadBlockSize
Unsupported GIF version	Unsupported GIF version	GIFImage_sBadVersion
Unsupported PNG data	Unsupported PNG data	PNGLoader_rsUnsupportedPNGData
Unsupported PixelFormat	Unsupported PixelFormat	GIFImage_sInvalidPixelFormat
Unsupported bitmap format	²»Ö§³ÖµÄÎ»Í¼¸ñÊ½	LinarBitmap_rsUnsupportedBitmapFormat
Unsupported clipboard format	²»Ö§³ÖµÄ¼ôÌù°å¸ñÊ½	Main_rsUnsupportedClipboardFormat	Consts_SUnknownClipboardFormat
Unsupported file format	²»Ö§³ÖµÄÎÄ¼þ¸ñÊ½	LinarBitmap_rsUnsupportedFileFormat
Unsupported pixel format	²»Ö§³ÖµÄÏñËØ¸ñÊ½	AnalyzerPlugins_rsUnsupportedPixelFormat	LinarBitmap_rsInvalidPixelFormat
Up	Up	Consts_SmkcUp
Value expected	Value expected	ExpressionEval_rsValueExpected
Value must be integer	ÊäÈëÖµ±ØÐëÎªÕûÊý	ValueEdits_rsValueMustBeInteger
Value not in allowed range: [%s - %s]	ÊäÈëÖµ²»ÔÚÔÊÐí·¶Î§ÄÚ: [%s - %s]	ValueEdits_rsValueNotInAllowedRangeSS
Variant method calls not supported	Variant method calls not supported	SysConst_SDispatchError
Variant or safe array index out of bounds	Variant or safe array index out of bounds	SysConst_SVarArrayBounds
Variant or safe array is locked	Variant or safe array is locked	SysConst_SVarArrayLocked
Variant overflow	Variant overflow	SysConst_SVarOverflow
Version	Version	TAboutBox: Version.Caption
Vertical	×ÝÏò	LinkEditor_rsVertical
Vertical scaling		TPropertyEditorForm: VertScaleAnchorBox.Hint
Vertical text alignment	×ÝÏò¶ÔÆë·½Ê½	TPropertyEditorForm: Panel4.Caption
Warning	¾¯¸æ	Consts_SMsgDlgWarning
Wed	ÖÜÈý	SysConst_SShortDayNameWed
Wednesday	ÐÇÆÚÈý	SysConst_SLongDayNameWed
What can I do?	ÎÒÄÜ×öÊ²Ã´£¿	TPleaseSupportForm: Label2.Caption
White	°×É«	ExtCtrls_clNameWhite
Width	¿í¶È	TPropertyEditorForm: Panel9.Caption
Width:	¿í¶È:	TPagePropertiesForm: Label1.Caption
Window Background	´°Ìå±³¾°É«	ExtCtrls_clNameWindow
Window Frame	´°Ìå¿ò¼Ü	ExtCtrls_clNameWindowFrame
Window Text	´°ÌåÎÄ×ÖÑÕÉ«	ExtCtrls_clNameWindowText
Windows Enhanced metafile	Windows Enhanced metafile	WMFLoader_rsWindowsEnhancedMetafile
Windows bitmap	Windows bitmap	BMPLoader_rsWindowsBitmap
Windows cursor	Windows cursor	ICOLoader_rsWindowsCursor
Windows icon	Windows icon	ICOLoader_rsWindowsIcon
Windows metafile	Windows metafile	WMFLoader_rsWindowsMetafile
Would you like to reset to the default Priority Schedule?	Would you like to reset to the default Priority Schedule?	Consts_SRestoreDefaultSchedule
Write	Write	SysConst_SWriteAccess
X:	X:	TDesignerSetupForm: Label1.Caption
Y:	Y:	TDesignerSetupForm: Label2.Caption
Yellow	»ÆÉ«	ExtCtrls_clNameYellow
Yes to &All	È«²¿Ñ¡ÊÇ(&A)	Consts_SMsgDlgYesToAll
You are not allowed to delete this item	¸ÃÏîÄ¿²»ÔÊÐíÒÆ³ý	Consts_SDeleteNotAllowed
Zoom	Ëõ·Å	TMainForm: ZoomBox.Hint	TMainForm: ZoomAction.Caption
Zsoft Paintbrush	Zsoft Paintbrush	PCXLoader_rsPCXImageFile
add %s	Ìí¼Ó %s	Main_rsAddS
add point	Ìí¼Ó¶¥µã	Main_rsAddPoint
e-mail	e-mail	TAboutBox: EMailLabel.Caption
edit properties	±à¼­ÊôÐÔ	Main_rsEditProperties
http://logicnet.dk/mail.php	http://logicnet.dk/mail.php	TAboutBox: EMailLabel.Hint
http://meesoft.logicnet.dk	http://meesoft.logicnet.dk	TAboutBox: WWWLabel.Hint	TAboutBox: WWWLabel.Caption
http://meesoft.logicnet.dk/DiagramDesigner/help.htm	http://meesoft.logicnet.dk/DiagramDesigner/help.htm	TMainForm: InternetHelpAction.Hint
http://meesoft.logicnet.dk/DiagramDesigner/support.htm	Ö§³Ö Diagram Designer	TMainForm: SupportAction.Hint
move	ÒÆ¶¯	Main_rsMove
rename	ÖØÃüÃû	Main_rsRename
size		Main_rsSize
· Develop plugins	Îª±¾Èí¼þ±àÐ´²å¼þ	TPleaseSupportForm: Label7.Caption
· Help improving the documentation	°ïÖú¸Ä½ø±¾Èí¼þµÄËµÃ÷ÎÄ¼þ	TPleaseSupportForm: Label5.Caption
· The easiest is to make a donation	×îÈÝÒ×µÄ·½Ê½ÊÇÌá¹©Ò»±Ê¾èÖú	TPleaseSupportForm: Label3.Caption
· Translate the program to your language	½«±¾Èí¼þ·­ÒëÎªÄãµÄÄ¸Óï	TPleaseSupportForm: Label6.Caption
¼ points	ÏñËØ	Main_rs1_4Points	TPropertyEditorForm: MarginEditLabel.Caption	TPropertyEditorForm: LineWidthEditLabel.Caption
DefaultCharset	134
